OOOOOOOOOOOOOOOOOOOOOOOOOOOOOOOOOOOOOOOOOOOOOOOOOOOOOOOOOOOOOOOOOOOOOOOOOOOOOOOOOOOOOOOPOOOOOOOOOOOOOOOOOOOOOOOOOOOOOOOOOOOOOOOOOOOOOOOOOOOOOOOOOOOOOOOOOOOOOOOOOOOOOOOOOOOOOOOOOOOOOOOOOOPOOOOOOOOOOOOOOOOOOOOOOOOOOOOOOOOOOOOOOOOOOOOOOOOOOOOOOOOOOOOOOOOOOOOOOOOOOOOOOOOOOOOOOOOOOOOOOOOOOPOOOOOOOOOOO
OOOOOOOOOOOOPOOOOOOOOOOOOOOOOOOOOPOOOOOOOOOOOOOOOOOOOOOOOOOOOOOOOOOOOOOOOPOOOOOOOOOOOOOOOOOOOOOOOOOOOOOOOOOOOOOPOOOOOOOOOOOOOOOOOOOOPOOOOOOOOOOOOOOOOOOOOOOOOOOOOOOOOOOOOOOOPOOOOOOOOOOOOOOOOOOOOOOOOOOOOOOOOOOOOOPOOOOOOOOOOOOOOOOOOOOPOOOOOOOOOOOOOOOOOOOOOOOOOOOOOOOOOOOOOOOPOOOOOOOOOOOOOOOOOOOOOOOOO
OOOOOOOOQOOOOOOOOOOOPOOOOOOOOOOOOOOOOOOOOOOOOOQOOOOOOOOPOOOOOOOOOOOOOOOQOOOOOOOOOOOOOOOOOOOOOOOOOOOOOOOOOOOOOOOPOOOOOOOOOOOOOOOOOOOOPOOOOOOOOOOOOOOOOOOOOOOOOOOOOOOOOOOOOOOOPOOOOOOOOOOOOOOOOOOOOOOOOOOOOOOOOOOOOOPOOOOOOOOOOOOOOOOOOOOPOOOOOOOOOOOOOOOOOOOOOOOOOOOOOOOOOOOOOOOPOOOOOOOOOOOOOOOOOOOOOOOOO
OOOOOOOOOOOOOOOOOOOOOOOOOOOOOOOOOOOOOOOOOOOOOOOOOOOOOOOOOOOOOOOOOOOOOOOOOOOOOOOOOOOOOOOOPOOOOOOOOOOOOOOOOOOOOOOPOOOOOOOOOOOOOOOOOOOOPOOOOOOOOOOOOOOOOOOOOOOOOOOOOOOOOOOOOOOOPOOOOOOOOOOOOOOOOOOOOOOOOOOOOOOOOOOOOOPOOOOOOOOOOOOOOOOOOOOPOOOOOOOOOOOOOOOOOOOOOOOOOOOOOOOOOOOOOOOPOOOOOOOOOOOOOOOOOOOOOOOOO
OOOOOOOOOOOOOOOOOOOOOOOOOOOOOOOOOOOOOOOOOOOOOOOOOOOOOOOOOOOOOOOOOOOOOOOOOOOOOOOOOOOOOOOOOOOOOOOOOOOOOOOOOOOOOOOPOOOOOOOOOOOOOOOOOOOOPOOOOOOOOOOOOOOOOOOOOOOOOOOOOOOOOOOOOOOOPOOOOOOOOOOOOOOOOOOOOOOOOOOOOOOOOOOOOOPOOOOOOOOOOOOOOOOOOOOPOOOOOOOOOOOOOOOOOOOOOOOOOOOOOOOOOOOOOOOPOOOOOOOOOOOOOOOOOOOOOOOOO
OOOOOOOOOOOOOOOOOOOOOOOOOOOOOOOOOOOOOOOOOOOOOOOOOOOOOOOOOOOOOOOOOOOOOOOOOOOOOOOOOOOOOOOOOOOOOOOOOOOOOOOOOOOOOOOPOOOOOOOOOOOOOOOOOOOOPOOOOOOOOOOOOOOOOOOOOOOOOOOOOOOOOOOOOOOOPOOOOOOOOOOOOOOOOOOOOOOOOOOOOOOOOOOOOOPOOOOOOOOOOOOOOOOOOOOPOOOOOOOOOOOOOOOOOOOOOOOOOOOOOOOOOOOOOOOPOOOOOOOOOOOOOOOOOOOOOOOOO
OOOOOOOOOOOOOOOOOOOOOOOOOOOQOOOOOOOOOOOOOOOOOOOOOOOOOOOOOOOOOOOOOOOOOOOOOOOOOOOOOOOOOOOOOOOOOOOOOOOOOOOOOOOOOOOPOOOOOOOOOOOOOOOOOOOOPOOOOOOOOOOOOOOOOOOOOOOOOOOOOOOOOOOOOOOOPOOOOOOOOOOOOOOOOOOOOOOOOOOOOOOOOOOOOOPOOOOOOOOOOOOOOOOOOOOPOOOOOOOOOOOOOOOOOOOOOOOOOOOOOOOOOOOOOOOPOOOOOOOOOOOOOOOOOOOOOOOOO
OOOOOOOOOOOOOOOOOOOOOOOOOOOOOOOOOOOOOOOOOQOOOOOOOOOOOPOOOOOOOOOOOOOOOOOOOOOOOOOOOOOOOOOOOOOOOOOOOOOOOOOOOOOOOOOPOOOOOOOOOOOOOOOOOOOOPOOOOOOOOOOOOOOOOOOOOOOOOOOOOOOOOOOOOOOOPOOOOOOOOOOOOOOOOOOOOOOOOOOOOOOOOOOOOOPOOOOOOOOOOOOOOOOOOOOPOOOOOOOOOOOOOOOOOOOOOOOOOOOOOOOOOOOOOOOPOOOOOOOOOOOOOOOOOOOOOOOOO
OOOOOOOOOOOOOOOOOOOOOPOOOOOOOOOOOOOOOOOOOOOOOOOOOOOOOOOOOOOOOOOOOOOOOOQOOOOOOOOOOOOOOOOOOOOOOOOOOOOOOOOOOOOOOOOPOOOOOOOOOOOOOOOOOOOOPOOOOOOOOOOOOOOOOOOOOOOOOOOOOOOOOOOOOOOOPOOOOOOOOOOOOOOOOOOOOOOOOOOOOOOOOOOOOOPOOOOOOOOOOOOOOOOOOOOPOOOOOOOOOOOOOOOOOOOOOOOOOOOOOOOOOOOOOOOPOOOOOOOOOOOOOOOOOOOOOOOOO
OOOOOOOOOOOOOOOOOOOOOOOOOOOOOOOOOOQOOOOQOOOOOOOOOOOOOOOOOOOOOOOOOOOOOOPOOOOOOOOOOOOOOOOOOOOOOOOOOOOOOOOOOOOOOOOPOOOOOOOOOOOOOOOOOOOOPOOOOOOOOOOOOOOOOOOOOOOOOOOOOOOOOOOOOOOOPOOOOOOOOOOOOOOOOOOOOOOOOOOOOOOOOOOOOOPOOOOOOOOOOOOOOOOOOOOPOOOOOOOOOOOOOOOOOOOOOOOOOOOOOOOOOOOOOOOPOOOOOOOOOOOOOOOOOOOOOOOOO
OOOOOOOOOOOOOOOOOOOOOOOOOOOOOOOOOOOOOOOOOOOOOOOOOOOOOOOOOOOOOOOOOOPOOOOOOOOOOOOOOOOOOOOOOOOOOOOOOOOOOOOOOOOOOOOPOOOOOOOOOOOOOOOOOOOOPOOOOOOOOOOOOOOOOOOOOOOOOOOOOOOOOOOOOOOOPOOOOOOOOOOOOOOOOOOOOOOOOOOOOOOOOOOOOOPOOOOOOOOOOOOOOOOOOOOPOOOOOOOOOOOOOOOOOOOOOOOOOOOOOOOOOOOOOOOPOOOOOOOOOOOOOOOOOOOOOOOOO
OOOOOOOOPOOOOOOOOOOOOOOOOOOOOOOOOOOOOOOOOOOOOOOOOOOOOOOOOOOOOOOOOOOOOOOOOOOOOOOOOOOOOOOOOOOOOOOOOOOOOOOOOOOOOOOPOOOOOOOOOOOOOOOOOOOOPOOOOOOOOOOOOOOOOOOOOOOOOOOOOOOOOOOOOOOOPOOOOOOOOOOOOOOOOOOOOOOOOOOOOOOOOOOOOOPOOOOOOOOOOOOOOOOOOOOPOOOOOOOOOOOOOOOOOOOOOOOOOOOOOOOOOOOOOOOPOOOOOOOOOOOOOOOOOOOOOOOOO
OOOOOOOOOOOOOOOOOOOOOOOOOOOOOOOOOOOOOOOOOOOOOOOOOOOOOOOOOOOOOOOOOOOOOOOOOOOOOOOOOOOOOOOOOOOOOOOOOOOOOOOOOOOOOOOPOOOOOOOOOOOOOOOOOOOOPOOOOOOOOOOOOOOOOOOOOOOOOOOOOOOOOOOOOOOOPOOOOOOOOOOOOOOOOOOOOOOOOOOOOOOOOOOOOOPOOOOOOOOOOOOOOOOOOOOPOOOOOOOOOOOOOOOOOOOOOOOOOOOOOOOOOOOOOOOPOOOOOOOOOOOOOOOOOOOOOOOOO
OOOOOOOOOOOOOOOOOOOOOOOPOOOOOOOOOOOOOOOOOOOOOOPOOOOOOOOOOOOOOOOOOOOOOPOOOOOOOOOOOQOOOOOOOOOOOOOOOOOOOOOOOOOOOOOPOOOOOOOOOOOOOOOOOOOOPOOOOOOOOOOOOOOOOOOOOOOOOOOOOOOOOOOOOOOOPOOOOOOOOOOOOOOOOOOOOOOOOOOOOOOOOOOOOOPOOOOOOOOOOOOOOOOOOOOPOOOOOOOOOOOOOOOOOOOOOOOOOOOOOOOOOOOOOOOPOOOOOOOOOOOOOOOOOOOOOOOOO
OOOOOOOOOOOOOOOOOOOOOOOOOOOOOOOOOOOOOOOOOOOOPOOOOOOOOOOOOOOOOOOOOOOOOOOOOOOOOOOOOOOOOOOOOOOOOOOOOOOOOOOOOOOOOOOPOOOOOOOOOOOOOOOOOOOOPOOOOOOOOOOOOOOOOOOOOOOOOOOOOOOOOOOOOOOOPOOOOOOOOOOOOOOOOOOOOOOOOOOOOOOOOOOOOOPOOOOOOOOOOOOOOOOOOOOPOOOOOOOOOOOOOOOOOOOOOOOOOOOOOOOOOOOOOOOPOOOOOOOOOOOOOOOOOOOOOOOOO
OOOOOOOOOOOOOOOOOOOOOOOOOOOOOOOOOOOOOOOOOOOOOOOOOOOOQOOOOOOOOOOOOOOOOOOOOOOOOOOOOOOOOOOOOOOOOOOOOOOOOOOOOOOOOOOPOOOOOOOOOOOOOOOOOOOOPOOOOOOOOOOOOOOOOOOOOOOOOOOOOOOOOOOOOOOOPOOOOOOOOOOOOOOOOOOOOOOOOOOOOOOOOOOOOOPOOOOOOOOOOOOOOOOOOOOPOOOOOOOOOOOOOOOOOOOOOOOOOOOOOOOOOOOOOOOPOOOOOOOOOOOOOOOOOOOOOOOOO
OOOOOOOOOOOOOOOOOOOOOOOOPOOOOOOOOOOOOOOOOOOOOOOOOOOOOOOPOOOOOOOOOOOOOOOOOOOOOOOOOOOOOOOOOOOOOOOOOOOOOOOOOOOOOOOPOOOOOOOOOOOOOOOOOOOOPOOOOOOOOOOOOOOOOOOOOOOOOOOOOOOOOOOOOOOOPOOOOOOOOOOOOOOOOOOOOOOOOOOOOOOOOOOOOOPOOOOOOOOOOOOOOOOOOOOPOOOOOOOOOOOOOOOOOOOOOOOOOOOOOOOOOOOOOOOPOOOOOOOOOOOOOOOOOOOOOOOOO
OOOOOOOOOOOOOOOOOOOOOOOOOOOOOOOOOOOOOOOOOOOOOOOOOOOOOOOOOOOOOOOOOOOOOOOOOOOOOOOOOOOOOOOOOOOOOOOOOOOOOOOOOOOOOOOPOOOOOOOOOOOOOOOOOOOOPOOOOOOOOOOOOOOOOOOOOOOOOOOOOOOOOOOOOOOOPOOOOOOOOOOOOOOOOOOOOOOOOOOOOOOOOOOOOOPOOOOOOOOOOOOOOOOOOOOPOOOOOOOOOOOOOOOOOOOOOOOOOOOOOOOOOOOOOOOPOOOOOOOOOOOOOOOOOOOOOOOOO
OOOOOOOOOOOOOOOOOOOOOOOOOOOOOOOOOOOOOOOOOOOOOOOOOOOOOOOOOOOOOOOOOOOOOOOOOOOOOOOOOOOOOOOOOOOOOOOOOOOOOOOOOOOOOOOPOOOOOOOOOOOOOOOOOOOOPOOOOOOOOOOOOOOOOOOOOOOOOOOOOOOOOOOOOOOOPOOOOOOOOOOOOOOOOOOOOOOOOOOOOOOOOOOOOOPOOOOOOOOOOOOOOOOOOOOPOOOOOOOOOOOOOOOOOOOOOOOOOOOOOOOOOOOOOOOPOOOOOOOOOOOOOOOOOOOOOOOOO
OOOOOOOOOOOOOOOOOOOOOOOOOOOOOOOOOPOOOOOOOOOOOOOOOOOOOOOOOOOOOOOOOOOOOOOOOOOOOOOOOOOOOOOOOOOOOOOOOOOOOOOOOOOOOOOPOOOOOOOOOOOOOOOOOOOOPOOOOOOOOOOOOOOOOOOOOOOOOOOOOOOOOOOOOOOOPOOOOOOOOOOOOOOOOOOOOOOOOOOOOOOOOOOOOOPOOOOOOOOOOOOOOOOOOOOPOOOOOOOOOOOOOOOOOOOOOOOOOOOOOOOOOOOOOOOPOOOOOOOOOOOOOOOOOOOOOOOOO
OOOOOOOOOOOPOOOOOOOOOOOOOOOOOOOOOOOOOOOOOOOOOOOOOOOOOOOOOOOOOOOOOOOOOOOOOPOOOOOOOOOOOOOOOOOOOOOOOOOOOOOOOOOOOOOPOOOOOOOOOOOOOOOOOOOOPOOOOOOOOOOOOOOOOOOOOOOOOOOOOOOOOOOOOOOOPOOOOOOOOOOOOOOOOOOOOOOOOOOOOOOOOOOOOOPOOOOOOOOOOOOOOOOOOOOPOOOOOOOOOOOOOOOOOOOOOOOOOOOOOOOOOOOOOOOPOOOOOOOOOOOOOOOOOOOOOOOOO
OOOOQOOOOOOOOOOOOOOOOOOOOOOOOOOQOOOOOOOOOOOOOOOOOOOOOOOOOOOOOOOOOOOOOOOOOOOOOOOOOOOOOOOOOOOOOOOOOOOOOOOOOOOOOOOPOOOOOOOOOOOOOOOOOOOOPOOOOOOOOOOOOOOOOOOOOOOOOOOOOOOOOOOOOOOOPOOOOOOOOOOOOOOOOOOOOOOOOOOOOOOOOOOOOOPOOOOOOOOOOOOOOOOOOOOPOOOOOOOOOOOOOOOOOOOOOOOOOOOOOOOOOOOOOOOPOOOOOOOOOOOOOOOOOOOOOOOOO
OOOOOOOOOOOOOOOOOOOOOOOOOOOOOOOOOOOOOOOOOOOOOOOOOOOOOOOOOOOOOOPOPOOOOOOOOOOOOOOOOOOOOOOOOOOOOOOOOOOOOOOOOOOOOOOPOOOOOOOOOOOOOOOOOOOOPOOOOOOOOOOOOOOOOOOOOOOOOOOOOOOOOOOOOOOOPOOOOOOOOOOOOOOOOOOOOOOOOOOOOOOOOOOOOOPOOOOOOOOOOOOOOOOOOOOPOOOOOOOOOOOOOOOOOOOOOOOOOOOOOOOOOOOOOOOPOOOOOOOOOOOOOOOOOOOOOOOOO
OOOOOOOOOOOOOOOOOOOOOOOOOOOOPOOOOOOOOOOOOOPOOOOOOOOOOOOOOOOOOOOOOOOOOOOOOOOOOOOOOPOOPOOOOOOOOOOOOOOOOOOOOOOOOOOPOOOOOOOOOOOOOOOOOOOOPOOOOOOOOOOOOOOOOOOOOOOOOJBBiBBHOOOOOOPOOOOOOOOOOOOOOOOOOOOOOOOOOOOOOOOOOOOOPOOOOOOOOOOOOOOOOOOOOPOOOOOOOOOOOOOOOOOOOOOOOOOOOOOOOOOOOOOOOPOOOOOOOOOOOOOOOOOOOOOOOOO
OOOOOOOOOOOOOOOOPOOOOOOOOOOOOOOOOOOOOOOOOOOOOOOOOOOOOOOOOOOOOOOOOOOOOOOOOOOOOOOOOOOOOOOOOOOOOOOOOOOOOOOOOOOOOOOPOOOOOOOOOOOOOOOOOOOOPOOOOOOOOOOOOOOPOOOOOOPOOJBBiBBHOOOOOOOOPOOOOOOOOOOOOOOOOOOOOOOOOOOOOOOOOOOOOOPOOOOOOOOOOOOOOOOOOOOPOOOOOOOOOOOOOOOOOOOOOOOOOOOOOOOOOOOOOOOPOOOOOOOOOOOOOOOOOOOOOOOOO
OOOOOOOOOOOOOOOOOOOOOOOOOOOOOOOOOOOOOOOOOOOOOOOOOOOOOOOOOOOOOOOOOOOOOOOOOOOOOOOOOOOOOOOOOOOOOOOOOOOOOOOOOOOOOOOPOOOOOOOOOOOOOOOOOOOOPOOOOOOOOOOOOOOOOOOOOOOOOJBBiBBHOOOOOOOOPOOOOOOOOOOOOOOOOOOOOOOOOOOOOOOOOOOOOOPOOOOOOOOOOOOOOOOOOOOPOOOOOOOOOOOOOOOOOOOOOOOOOOOOOOOOOOOOOOOPOOOOOOOOOOOOOOOOOOOOOOOOO
OOOOOOOOOOOOOOOOOOOOOOOOOOOOOOOOOOOOOOOOOOOOOOOOOOOOOQOOOOOOOPOOOOOOOOOOOOOOOOOOOOOOOOOOOPOOOOOOOOOOOOOOOOOOOOOPOOOOOOOOOOOOOOOOOOOOPOOOOOOOOOOOOOOeaaaaaaaafJBBiBBHOOOOOOOOPOOOOOOOOOOOOOOOOOOOOOOOOOOOOOOOOOOOOOPOOOOOOOOOOOOOOOOOOOOPOOOOOOOOOOOOOOOOOOOOOOOOOOOOOOOOOOOOOOOPOOOOOOOOOOOOOOOOOOOOOOOOO
OOOOOOOOOOPOOOOOOOOOOOOOOOOPOOOOOOOOOOOOOOOOOOOOOOOOOOOOOOOOOOOOOOOOOOOOOOOOOOOOOOOOOOOOOOOOOOOOOOOOOOOOOOOOOOOPOOOOOOOOOOOOOOOOOOOOPOOOOOOOOOOOOOOdYYYYYYYYcJBBiBBHOOOOOOOOPOOOOOOOOOOOOOOOOOOOOOOOOOOOOOOOOOOOOOPOOOOOOOOOOOOOOOOOOOOPOOOOOOOOOOOOOOOOOOOOOOOOOOOOOOOOOOOOOOOPOOOOOOOOOOOOOOOOOOOOOOOOO
OOOOOOOOOOOOOOOOOOOOOOOOOOOOOOOOOOOOOOOOOOOOOOOOOOOOOOOOOOOOOOOOOOOOOOOOOPOOOOOOOOOOOOOOOOOOOOOOOOOOOOOOOOOOOOOPOOOOOOOOOOOOOOOOOOOOPOOOOOOOOOOOOOOSSSSSSSSSSJBBiBBHOOOOOOOOPOOOOOOOOOOOOOOOOOOOOOOOOOOOOOOOOOOOOOPOOOOOOOOOOOOOOOOOOOOPOOOOOOOOOOOOOOOOOOOOOOOOOOOOOOOOOOOOOOOPOOOOOOOOOOOOOOOOOOOOOOOOO
OOOOOOOOOOOOOOOOOOOOOOOOOOOOOOOOOOOOOOOOOOOOOOOPOOOOOOOOQOOOOOOOOOOOOOOOOOOOOOOOOOOOOOOOOOOOOOOOOOOOOOOOOOOOOOSSSSSSOOOOOOOOOOOOOOOOPOOOOOOOOOOOOOOSSSSSSSSSSJBBiBBHOOOOOOOOPOOOOOOOOOOOOOOOOOOOOOOOOOOOOOOOOOOOOOPOOOOOOOOOOOOOOOOOOOOPOOOOOOOOOOOOOOOOOOOOOOOOOOOOOOOOOOOOOOOPOOOOOOOOOOOOOOOOOOOOOOOOO
OOOOOOOOOOOOOOOOOOOOOOOOOOOOOOOOOOOOOOOOOOOOOOOOOOOOOOOOOOOOOOOOOOOOOOOOOOOOOOOOOOOOOOOOOOOOOOOOOOOOOOOOSSSSSOSSSSSOOOOOOOOOOOOOOOOOPOOOOOOOOOOOOOOSSSSWWSSSSJBBiBBHOOOOOOOOPOOOOOOOOOOOOOOOOOOOOOOOOOOOOOOOOOOOOOPOOOOOOOOOOOOOOOOOOOOPOOOOOOOOOOOOOOOOOOOOOOOOOOOOOOOOOOOOOOOPOOOOOOOOOOOOOOOOOOOOOOOOO
GGGGGGGGGGGGGGGGGGGGGGGGGGGGGGGGGGGGGGGGGGGGGGGGGGGGGGGGGGGGGGGGGGGGGGGGGGGGGGGGGGGGGGGGGGGGGGGGGGGGGGGGGGGGGGGGGGGGGGGGGGGGGGGGGGGGGGGGGGGGGGGGGGGGGGGGGGGGGKBBmBBLGGGGGGGGGGGGGGGGGGGGGGGGGGGGGGGGGGGGGGGGGGGGGGGGGGGGGGGGGGGGGGGGGGGGGGGGGGGGGGGGGGGGGGGGGGGGGGGGGGGGGGGGGGGGGGGGGGGGGGGGGGGGGGGGGGGGG
AAAAAAAAAAAAAAAAAAAAAAAAAAAAAAAAAAAAAAAAAAAAAAAAAAAAAAAAAAAAAAAAAAAAAAAAAAAAAAAAAAAAAAAAAAAAAAAAAAAAAAAAAAAAAAAAAAAAAAAAAAAAAAAAAAAAAAAAAAAAAAAAAAAAAAAAAAAAAACBhBDAAAAAAAAAAAAAAAAAAAAAAAAAAAAAAAAAAAAAAAAAAAAAAAAAAAAAAAAAAAAAAAAAAAAAAAAAAAAAAAAAAAAAAAAAAAAAAAAAAAAAAAAAAAAAAAAAAAAAAAAAAAAAAAAAAAAAA
AAAAAAAAAAAAAAAAAAAAAAAAAAAAAAAAAAAAAAAAAAAAAAAAAAAAAAAAAAAAAAAAAAAAAAAAAAAAAAAAAAAAAAAAAAAAAAAAAAAAAAAAAAAAAAAAAAAAAAAAAAAAAAAAAAAAAAAAAAAAAAAAAAAAAAAAAAAAAAAChDAAAAAAAAAAAAAAAAAAAAAAAAAAAAAAAAAAAAAAAAAAAAAAAAAAAAAAAAAAAAAAAAAAAAAAAAAAAAAAAAAAAAAAAAAAAAAAAAAAAAAAAAAAAAAAAAAAAAAAAAAAAAAAAAAAAAAAA
AAAAAAAAAAAAAAAAAAAAAAAAAAAAAAAAAAAAAAAAAAAAAAAAAAAAAAAAAAAAAAAAAAAAAAAAAAAAAAAAAAAAAAAAAAAAAAAAAAAAAAAAAAAAAAAAAAAAAAAAAAAAAAAAAAAAAAAAAAAAAAAAAAAAAAAAAAAAAAAAAAAAAAAAAAAAAAAAAAAAAAAAAAAAAAAAAAAAAAAAAAAAAAAAAAAAAAAAAAAAAAAAAAAAAAAAAAAAAAAAAAAAAAAAAAAAAAAAAAAAAAAAAAAAAAAAAAAAAAAAAAAAAAAAAAAAAAAAA
IIIIIIIIIIIIIIIIIIIIIIIIIIIIIIIIIIIIIIIIIIIIIIIIIIIIIIIIIIIIIIIIIIIIIIIIIIIIIIIIIIIIIIIIIIIIIIIIIIIIIIIIIIIIIIIIIIIIIIIIIIIIIIIIIIIIIIIIIIIIIIIIIIIIIIIIIIIIIIIIIIIIIIIIIIIIIIIIIIIIIIIIIIIIIIIIIIIIIIIIIIIIIIIIIIIIIIIIIIIIIIIIIIIIIIIIIIIIIIIIIIIIIIIIIIIIIIIIIIIIIIIIIIIIIIIIIIIIIIIIIIIIIIIIIIIIIIIII
jjjjjjjjjjjjjjjjjjjjjjjjjjjjjjjjjjjjjjjjjjjjjjjjjjjjjjjjjjjjjjjjjjjjjjjjjjjjjjjjjjjjjjjjjjjjjjjjjjjjjjjjjjjjjjjjjjjjjjjjjjjjjjjjjjjjjjjjjjjjjjjjjjjjjjjjjjjjjjjjjjjjjjjjjjjjjjjjjjjjjjjjjjjjjjjjjjjjjjjjjjjjjjjjjjjjjjjjjjjjjjjjjjjjjjjjjjjjjjjjjjjjjjjjjjjjjjjjjjjjjjjjjjjjjjjjjjjjjjjjjjjjjjjjjjjjjjjjj
GGGGGGGGGGGGGGGGGGGGGGGGGGGGGGGGGGGGGGGGGGGGGGGGGGGGGGGGGGGGGGGGGGGGGGGGGGGGGGGGGGGGGGGGGGGGGGGGGGGGGGGGGGGGGGGGGGGGGGGGGGGGGGGGGGGGGGGGGGGGGGGGGGGGGGGGGGGGGGGGGGGGGGGGGGGGGGGGGGGGGGGGGGGGGGGGGGGGGGGGGGGGGGGGGGGGGGGGGGGGGGGGGGGGGGGGGGGGGGGGGGGGGGGGGGGGGGGGGGGGGGGGGGGGGGGGGGGGGGGGGGGGGGGGGGGGGGGGG
AAAAAAAAAAAAAAAAAAAAAAAAAAAAAAAAAAAAAAAAAAAAAAAAAAAAAAAAAAAAAAAAAAAAAAAAAAAAAAAAAAAAAAAAAAAAAAAAAAAAAAAAAAAAAAAAAAAAAAAAAAAAAAAAAAAAAAAAAAAAAAAAAAAAAAAAAAAAAAAAAAAAAAAAAAAAAAAAAAAAAAAAAAAAAAAAAAAAAAAAAAAAAAAAAAAAAAAAAAAAAAAAAAAAAAAAAAAAAAAAAAAAAAAAAAAAAAAAAAAAAAAAAAAAAAAAAAAAAAAAAAAAAAAAAAAAAAAAA
AAAAAAAAAAAAAAAAAAAAAAAAAAAAAAAAAAAAAAAAAAAAAAAAAAAAAAAAAAAAAAAAAAAAAAAAAAAAAAAAAAAAAAAAAAAAAAAAAAAAAAAAAAAAAAAAAAAAAAAAAAAAAAAAAAAAAAAAAAAAAAAAAAAAAAAAAAAAAAAAAAAAAAAAAAAAAAAAAAAAAAAAAAAAAAAAAAAAAAAAAAAAAAAAAAAAAAAAAAAAAAAAAAAAAAAAAAAAAAAAAAAAAAAAAAAAAAAAAAAAAAAAAAAAAAAAAAAAAAAAAAAAAAAAAAAAAAAAA
AAAAAAAAAAAAAAAAAAAAAAAAAAAAAAAAAAAAAAAAAAAAAAAAAAAAAAAAAAAAAAAAAAAAAAAAAAAAAAAAAAAAAAAAAAAAAAAAAAAAAAAAAAAAAAAAAAAAAAAAAAAAAAAAAAAAAAAAAAAAAAAAAAAAAAAAAAAAAAAAAAAAAAAAAAAAAAAAAAAAAAAAAAAAAAAAAAAAAAAAAAAAAAAAAAAAAAAAAAAAAAAAAAAAAAAAAAAAAAAAAAAAAAAAAAAAAAAAAAAAAAAAAAAAAAAAAAAAAAAAAAAAAAAAAAAAAAAAA
IIIIIIIIIIIIIIIIIIIIIIIIIIIIIIIIIIIIIIIIIIIIIIIIIIIIIIIIIIIIIIIIIIIIIIIIIIIIIIIIIIIIIIIIIIIIIIIIIIIIIIIIIIIIIIIIIIIIIIIIIIIIIIIIIIIIIIIIIIIIIIIIIIIIIIIIIIIIIIIIIIIIIIIIIIIIIIIIIIIIIIIIIIIIIIIIIIIIIIIIIIIIIIIIIIIIIIIIIIIIIIIIIIIIIIIIIIIIIIIIIIIIIIIIIIIIIIIIIIIIIIIIIIIIIIIIIIIIIIIIIIIIIIIIIIIIIIIII
OOOOOOOOOOOOOOOOOOOOOOOOOOOOOOOOOOOOOOOOOOOOOOOOOOOOOOOOOOOOOOOOOOOOOOOOOOOOOOOOOOOOOOOOOOOOOOOOOOOOOOOOOOOOOOOPOOOOOOOOOOOOOOOOOOOOPOOOOOOOOOOOOOOOOOOOOOOOOOOOOOOOOOOOOOOOPOOOOOOOOOOOOOOOOOOOOOOOOOOOOOOOOOOOOOPOOOOOOOOOOOOOOOOOOOOPOOOOOOOOOOOOOOOOOOOOOOOOOOOOOOOOOOOOOOOPOOOOOOOOOOOOOOOOOOOOOOOOO
OOOOOOOOOOOOOOOOOOOOOOOOOOOOOOOOOOOOOOOOOOOOOOOOOOOOOOOOOOOOOOOOOOOOOOOOOOOOOOOOOOOOOOOOOOOOOOOOOOOOOOOOOOOOOOOPOOOOOOOOOOOOOOOOOOOOPOOOOOOOOOOOOOOOOOOOOOOOOOOOOOOOOOOOOOOOPOOOOOOOOOOOOOOOOOOOOOOOOOOOOOOOOOOOOOPOOOOOOOOOOOOOOOOOOOOPOOOOOOOOOOOOOOOOOOOOOOOOOOOOOOOOOOOOOOOPOOOOOOOOOOOOOOOOOOOOOOOOO
OOOOOOOOOOOOOOOOOOOOOOOOOOOOOOOOOOOOOOOOOOOOOOOOOOOOOOOOOOOOOOOOOOOOOOOOOOOOOOOOOOOOOOOOOOOOOOOOOOOOOOOOOOOOOOOPOOOOOOOOOOOOOOOOOOOOPOOOOOOOOOOOOOOOOOOOOOOOOOOOOOOOOOOOOOOOPOOOOOOOOOOOOOOOOOOOOOOOOOOOOOOOOOOOOOPOOOOOOOOOOOOOOOOOOOOPOOOOOOOOOOOOOOOOOOOOOOOOOOOOOOOOOOOOOOOPOOOOOOOOOOOOOOOOOOOOOOOOO
OOOOOOOOOOOOOOPOOOOOOOOOOOOOOOOOOOOOOOOOOOOOOOOOOOOOOOOOOOOOOOOOOOOOOOOOOOOOOOOOOOOOOOOOOOOOOOOOOOOOOOOOOOOOOOOPOOOOOOOOOOOOOOOOOOOOPOOOOOOOOOOOOOOOOOOOOOOOOOOOOOOOOOOOOOOOPOOOOOOOOOOOOOOOOOOOOOOOOOOOOOOOOOOOOOPOOOOOOOOOOOOOOOOOOOOPOOOOOOOOOOOOOOOOOOOOOOOOOOOOOOOOOOOOOOOPOOOOOOOOOOOOOOOOOOOOOOOOO
OOOOOOOOOOOOOOOOOOOOOOOOOOOOOOOOOOOOOOOOOOOOOOOOOOOOOOOOOOOOOOOOOOOOOOOOOOOOOOOOOOOOOOOOOOOOOOOOOOOOOOOOOOOOOOOPOOOOOOOOOOOOOOOOOOOOPOOOOOOOOOOOOOOOOOOOOOOOOOOOOOOOOOOOOOOOPOOOOOOOOOOOOOOOOOOOOOOOOOOOOOOOOOOOOOPOOOOOOOOOOOOOOOOOOOOPOOOOOOOOOOOOOOOOOOOOOOOOOOOOOOOOOOOOOOOPOOOOOOOOOOOOOOOOOOOOOOOOO
OOOOOOOOOOOOOOOOOOOOOOOOOOOOOOOOOOOPPOOOOOOOOOOOOOOOOOOOOOOOOOOOOOOOOOOOOOOOOOOOOOOPOOOOOOOOOOOOOOOOOOOOOOOOOOOPOOOOOOOOOOOOOOOOOOOOPOOOOOOOOOOOOOOOOOOOOOOOOOOOOOOOOOOOOOOOPOOOOOOOOOOOOOOOOOOOOOOOOOOOOOOOOOOOOOPOOOOOOOOOOOOOOOOOOOOPOOOOOOOOOOOOOOOOOOOOOOOOOOOOOOOOOOOOOOOPOOOOOOOOOOOOOOOOOOOOOOOOO
OOOOOOOOOOOOOOOOOOOOOOOOOOOOOOOOOOOOOOOOOOOOOOOOOOOOOOOOOOOOOOOOOOOOOOOOOOOOOOOOOOOOOOOOOOOOOOOOOOOOOOOOOOOOOOOPOOOOOOOOOOOOOOOOOOOOPOOOOOOOOOOOOOOOOOOOOOOOOOOOOOOOOOOOOOOOPOOOOOOOOOOOOOOOOOOOOOOOOOOOOOOOOOOOOOPOOOOOOOOOOOOOOOOOOOOPOOOOOOOOOOOOOOOOOOOOOOOOOOOOOOOOOOOOOOOPOOOOOOOOOOOOOOOOOOOOOOOOO
OOOOOOOOOOOOOOOOOOOOPOOOOOOOOOOOOOOOOOOOOOOOOOOOOOOOOOOOOOOOOOOOOOOOOOOOOOOOOOOOOOOOOOOOOOOOOOOOOOOOOOOOOOOOOOOPOOOOOOOOOOOOOOOOOOOOPOOOOOOOOOOOOOOOOOOOOOOOOOOOOOOOOOOOOOOOPOOOOOOOOOOOOOOOOOOOOOOOOOOOOOOOOOOOOOPOOOOOOOOOOOOOOOOOOOOPOOOOOOOOOOOOOOOOOOOOOOOOOOOOOOOOOOOOOOOPOOOOOOOOOOOOOOOOOOOOOOOOO
OOOOOOOOOOOOOOOOOOOOOOOOOOOOOOOOOOOOOOOOOOOOOOOOOOOOOOOOOOOOOOOOOOOOOOOOOOOOOOOOOOOOOOOOOOOOOOOOOOOOOOOOOOOOOOOPOOOOOOOOOOOOOOOOOOOOPOOOOOOOOOOOOOOOOOOOOOOOOOOOOOOOOOOOOOOOPOOOOOOOOOOOOOOOOOOOOOOOOOOOOOOOOOOOOOPOOOOOOOOOOOOOOOOOOOOPOOOOOOOOOOOOOOOOOOOOOOOOOOOOOOOOOOOOOOOPOOOOOOOOOOOOOOOOOOOOOOOOO
OOOOOOOOOOOOOOOOOOOOOOOOOOOOOOOOOOOOOOOOOOOOOOOOOOOOOOOOOOOPOOOOOOOOOOOOOOOOOOOOOOOOOOOOOOOOOOOOOOOOOOOOOOOOOOOPOOOOOOOOOOOOOOOOOOOOPOOOOOOOOOOOOOOOOOOOOOOOOOOOOOOOOOOOOOOOPOOOOOOOOOOOOOOOOOOOOOOOOOOOOOOOOOOOOOPOOOOOOOOOOOOOOOOOOOOPOOOOOOOOOOOOOOOOOOOOOOOOOOOOOOOOOOOOOOOPOOOOOOOOOOOOOOOOOOOOOOOOO
OOOOOOOOOOOOOOOOOOOOOPOOOOOOOOOOOOOOOPOOOOOOOOOOOOOOOOOOOOOOOOOOOOOOOOOOOOOOOOOOOOOOPOOOOOOOOOOOOOOOOOOOOOOOOOOPOOOOOOOOOOOOOOOOOOOOPOOOOOOOOOOOOOOOOOOOOOOOOOOOOOOOOOOOOOOOPOOOOOOOOOOOOOOOOOOOOOOOOOOOOOOOOOOOOOPOOOOOOOOOOOOOOOOOOOOPOOOOOOOOOOOOOOOOOOOOOOOOOOOOOOOOOOOOOOOPOOOOOOOOOOOOOOOOOOOOOOOOO
OOOOOOOOOOOOOOOOOOOOOOOOOOOOOOOOOOOOOOOOOOOOOOOOOOOOOOOOOOOOOOOOOOOOOOOOOOOOOOOOOOOOOOOOOOOOOOOOOOOOOOOOOOOOOOOPOOOOOOOOOOOOOOOOOOOOPOOOOOOOOOOOOOOOOOOOOOOOOOOOOOOOOOOOOOOOPOOOOOOOOOOOOOOOOOOOOOOOOOOOOOOOOOOOOOPOOOOOOOOOOOOOOOOOOOOPOOOOOOOOOOOOOOOOOOOOOOOOOOOOOOOOOOOOOOOPOOOOOOOOOOOOOOOOOOOOOOOOO
OOOOOOOOOOOOOOOOOOOPOOOOOOOOOOOOOOOOOOOOOOOOOOOOOOOOOOOOOOOOOOOOOOOOOOOOOOOOOOOOOOOOOOOOOOOOOOOOOOOOOOOOOOOOOOOPOOOOOOOOOOOOOOOOOOOOPOOOOOOOOOOOOOOOOOOOOOOOOOOOOOOOOOOOOOOOPOOOOOOOOOOOOOOOOOOOOOOOOOOOOOOOOOOOOOPOOOOOOOOOOOOOOOOOOOOPOOOOOOOOOOOOOOOOOOOOOOOOOOOOOOOOOOOOOOOPOOOOOOOOOOOOOOOOOOOOOOOOO
OOOOOOOOOOOOOOOOOOOOOOOOOOOPOOOOOOOOOOOOOOOOOOOOOOOOOOOOOOOOOOPOOOOOOOOOOOOOOOOOOOOOOOOOOOOOOOOOOOOOOOOOOOOOOOOPOOOOOOOOOOOOOOOOOOOOPOOOOOOOOOOOOOOOOOOOOOOOOOOOOOOOOOOOOOOOPOOOOOOOOOOOOOOOOOOOOOOOOOOOOOOOOOOOOOPOOOOOOOOOOOOOOOOOOOOPOOOOOOOOOOOOOOOOOOOOOOOOOOOOOOOOOOOOOOOPOOOOOOOOOOOOOOOOOOOOOOOOO
OOOOOOOOOOOOOOOOOOOOOOOOOOOOOOOOOOOOOOOOOOOOOOOOOOOOOOOOOOOOOOOOOOOOOOOOOOOOOOOOOOOOOOOOOOOOOOOOOOOOOOOOOOOOOOOPOOOOOOOOOOOOOOOOOOOOPOOOOOOOOOOOOOOOOOOOOOOOOOOOOOOOOOOOOOOOPOOOOOOOOOOOOOOOOOOOOOOOOOOOOOOOOOOOOOPOOOOOOOOOOOOOOOOOOOOPOOOOOOOOOOOOOOOOOOOOOOOOOOOOOOOOOOOOOOOPOOOOOOOOOOOOOOOOOOOOOOOOO
OOOOOOOOOOOOOOOOOOOOOOOOOOOOOOOOOOOOOOOOOOOOOOOOOOOOOOOOOOOOOOOOOOOOOOOOOOOOOOOPOOOOOOOOOOOOOOOOOOOOOOOOOOOOOOOPOOOOOOOOOOOOOOOOOOOOPOOOOOOOOOOOOOOOOOOOOOOOOOOOOOOOOOOOOOOOPOOOOOOOOOOOOOOOOOOOOOOOOOOOOOOOOOOOOOPOOOOOOOOOOOOOOOOOOOOPOOOOOOOOOOOOOOOOOOOOOOOOOOOOOOOOOOOOOOOPOOOOOOOOOOOOOOOOOOOOOOOOO
OOOOOOOOOOOOOOOOOOOOOOPOOOOOOOOOOOOOOOOOOOOOOOOOOOOOOOOOOOOOOOOOOOOOOOOOOOOOOOOOOOOOOOOOOOOOOOOOOOOOOOOOOOOOOOOPOOOOOOOOOOOOOOOOOOOOPOOOOOOOOOOOOOOOOOOOOOOOOOOOOOOOOOOOOOOOPOOOOOOOOOOOOOOOOOOOOOOOOOOOOOOOOOOOOOPOOOOOOOOOOOOOOOOOOOOPOOOOOOOOOOOOOOOOOOOOOOOOOOOOOOOOOOOOOOOPOOOOOOOOOOOOOOOOOOOOOOOOO
OOOOOOOOOOOOOOOOOOOOOOOOOOOOOOOOOOOOOOOOOOOOOOOOOPOOOOOOOOOOOOOOOOPOOOOOOOOOOOOOOOOOOOOOOOOOOOOOOOOOOOOOOOOOOOOPOOOOOOOOOOOOOOOOOOOOPOOOOOOOOOOOOOOOOOOOOOOOOOOOOOOOOOOOOOOOPOOOOOOOOOOOOOOOOOOOOOOOOOOOOOOOOOOOOOPOOOOOOOOOOOOOOOOOOOOPOOOOOOOOOOOOOOOOOOOOOOOOOOOOOOOOOOOOOOOPOOOOOOOOOOOOOOOOOOOOOOOOO
OOOOOOOOOOOOPOOOOOOOOOOOOOOOOOOOOOOOOOOOOOOOOOOOOOOOOOOOOOOOOOOOOOOOOOOOOOOOOOOOOOOOOOOOOOOOOOOOOOOOOOOOOOOOOOOPOOOOOOOOOOOOOOOOOOOOPOOOOOOOOOOOOOOOOOOOOOOOOOOOOOOOOOOOOOOOPOOOOOOOOOOOOOOOOOOOOOOOOOOOOOOOOOOOOOPOOOOOOOOOOOOOOOOOOOOPOOOOOOOOOOOOOOOOOOOOOOOOOOOOOOOOOOOOOOOPOOOOOOOOOOOOOOOOOOOOOOOOO
OOOOOOOOQOOOOOOOOOOOOOPOOOOOOOOOOOOOOOOOOOOOOOOOOOOOOOOOOOOOOOOOOOOOQOOOOOOOOOOOPOOOOOOOOOOOOOOOOOOOOOOOOOOOOOOPOOOOOOOOOOOOOOOOOOOOPOOOOOOOOOOOOOOOOOOOOOOOOOOOOOOOOOOOOOOOPOOOOOOOOOOOOOOOOOOOOOOOOOOOOOOOOOOOOOPOOOOOOOOOOOOOOOOOOOOPOOOOOOOOOOOOOOOOOOOOOOOOOOOOOOOOOOOOOOOPOOOOOOOOOOOOOOOOOOOOOOOOO
OOOOOOOOOOOOOOOOOOOOOOOOOOOOOOOOOOOOOOOOOOOOOOOOOOOOOOOOOOOPOOOOOOOOOOOOOOOOOOOOOOOOOOOOOOOOOOOOOOOOOOOOOOOOOOOPOOOOOOOOOOOOOOOOOOOOPOOOOOOOOOOOOOOOOOOOOOOOOOOOOOOOOOOOOOOOPOOOOOOOOOOOOOOOOOOOOOOOOOOOOOOOOOOOOOPOOOOOOOOOOOOOOOOOOOOPOOOOOOOOOOOOOOOOOOOOOOOOOOOOOOOOOOOOOOOPOOOOOOOOOOOOOOOOOOOOOOOOO
OOOOOOOOOOOOOOOOOOOOOOOOOOOOOOOOOOOOOOOOOOOOOOOOOOOOOOOOOQOOOOOOOOOOOOOOOOOOOOOOOOOOOOOOOOOOOOOOOOOOOOOOOOOOOOOPOOOOOOOOOOOOOOOOOOOOPOOOOOOOOOOOOOOOOOOOOOOOOOOOOOOOOOOOOOOOPOOOOOOOOOOOOOOOOOOOOOOOOOOOOOOOOOOOOOPOOOOOOOOOOOOOOOOOOOOPOOOOOOOOOOOOOOOOOOOOOOOOOOOOOOOOOOOOOOOPOOOOOOOOOOOOOOOOOOOOOOOOO
OOOOOOOOOOOOOOOOOOOOOOOOOOOOOOOOOOOOOOOOOOOOOOOOOOOOOOOOOOOOOOOOOOOOOOOOOOOOOOOOOOOOOOOOOOOOOOOOOOOOOOOOOOOOOOOPOOOOOOOOOOOOOOOOOOOOPOOOOOOOOOOOOOOOOOOOOOOOOOOOOOOOOOOOOOOOPOOOOOOOOOOOOOOOOOOOOOOOOOOOOOOOOOOOOOPOOOOOOOOOOOOOOOOOOOOPOOOOOOOOOOOOOOOOOOOOOOOOOOOOOOOOOOOOOOOPOOOOOOOOOOOOOOOOOOOOOOOOO
OOOOOOOOOOOOOOOOOOOOOOOOOOOOOOOOOOOOOOOOOOOOOOOOOOOOOOOOOOOOOOOOOOOOOOOOOOOOOOOOOOOOOOOOOOOOOOOOOOOOOOOOOOOOOOOPOOOOOOOOOOOOOOOOOOOOPOOOOOOOOOOOOOOOOOOOOOOOOOOOOOOOOOOOOOOOPOOOOOOOOOOOOOOOOOOOOOOOOOOOOOOOOOOOOOPOOOOOOOOOOOOOOOOOOOOPOOOOOOOOOOOOOOOOOOOOOOOOOOOOOOOOOOOOOOOPOOOOOOOOOOOOOOOOOOOOOOOOO
OOOOOOOOOOOOOOOOOOOOOOOOOOOOOOOOOOOOOOOOOOOOOOOOOOOOOOOOPOOOOOOOOOOOOOOOOOOOOOOOOOOOOOOOOQOOOOOOOOOOOOOOOOOOOOOPOOOOOOOOOOOOOOOOOOOOPOOOOOOOOOOOOOOOOOOOOOOOOOOOOOOOOOOOOOOOPOOOOOOOOOOOOOOOOOOOOOOOOOOOOOOOOOOOOOPOOOOOOOOOOOOOOOOOOOOPOOOOOOOOOOOOOOOOOOOOOOOOOOOOOOOOOOOOOOOPOOOOOOOOOOOOOOOOOOOOOOOOO
OOOOOOOOOOOOOOOOOOOOOOOOOQOOOOOOOOPOOOOOOOOOOOOOOOOOOOOOOOOOOOQOOOOOOOOOOOOOOOOOOOOOOOOOOOOOOOOOOOOOOOOOOOOOOOOPOOOOOOOOOOOOOOOOOOOOPOOOOOOOOOOOOOOOOOOOOOOOOOOOOOOOOOOOOOOOPOOOOOOOOOOOOOOOOOOOOOOOOOOOOOOOOOOOOOPOOOOOOOOOOOOOOOOOOOOPOOOOOOOOOOOOOOOOOOOOOOOOOOOOOOOOOOOOOOOPOOOOOOOOOOOOOOOOOOOOOOOOO
OOOOOOOOOOOOOOOOOOOOOOOOOOOOPOOOOOOOOPOOOOOOOOOOOOOOOOOOOOOOOOOOOOOOOPOOOOOOPOOOOOOOOOOOOOOOOOOOOOOOOOOOOOOOOOOPOOOOOOOOOOOOOOOOOOOOPOOOOOOOOOOOOOOOOOOOOOOOOOOOOOOOOOOOOOOOPOOOOOOOOOOOOOOOOOOOOOOOOOOOOOOOOOOOOOPOOOOOOOOOOOOOOOOOOOOPOOOOOOOOOOOOOOOOOOOOOOOOOOOOOOOOOOOOOOOPOOOOOOOOOOOOOOOOOOOOOOOOO
OOOOOOOOOOOOOOOOOOOOOOOOOOOOOOOOOOOOOOOOOOOOOOOOOOOOOQOOOOOOOOOOOOOOOOOOOOOOOOOOOOOOOOOOOOOOOOOOOOOOOOOOOOOOOOOPOOOOOOOOOOOOOOOOOOOOPOOOOOOOOOOOOOOOOOOOOOOOOOOOOOOOOOOOOOOOPOOOOOOOOOOOOOOOOOOOOOOOOOOOOOOOOOOOOOPOOOOOOOOOOOOOOOOOOOOPOOOOOOOOOOOOOOOOOOOOOOOOOOOOOOOOOOOOOOOPOOOOOOOOOOOOOOOOOOOOOOOOO
OOOOOOOOOOOOOOOOOOOOOOOOOOOOOOOOOOOOOOOOOOOOOOOOOOOOOOOOOOOOOOOOOOOOOOOOOOOOOOOOOOOOOOOOOOOOOOOOOOOOOOOOOOOOOOOPOOOOOOOOOOOOOOOOOOOOPOOOOOOOOOOOOOOOOOOOOOOOOOOOOOOOOOOOOOOOPOOOOOOOOOOOOOOOOOOOOOOOOOOOOOOOOOOOOOPOOOOOOOOOOOOOOOOOOOOPOOOOOOOOOOOOOOOOOOOOOOOOOOOOOOOOOOOOOOOPOOOOOOOOOOOOOOOOOOOOOOOOO
OOOOOOOOOOOOOOOOOOOOOOOOOOOOOOOOOOOOOOOOOOOOOOOOOOOOOOOOOOOOOOOOOOOOOOOOOOOOOOOOOOOOOOOOOOOOOOOOOOOOOOOOOOOOOOOPOOOOOOOOOOOOOOOOOOOOPOOOOOOOOOOOOOOOOOOOOOOOOOOOOOOOOOOOOOOOPOOOOOOOOOOOOOOOOOOOOOOOOOOOOOOOOOOOOOPOOOOOOOOOOOOOOOOOOOOPOOOOOOOOOOOOOOOOOOOOOOOOOOOOOOOOOOOOOOOPOOOOOOOOOOOOOOOOOOOOOOOOO
OOOOOOOPOOOOOOOOOOOOOOOOOQOOOOOOOOOOOOOOOOOOOOOOOOOOOOOOOOOOOOOOOOOOOOOOOOOOOOOOOOOOOOOOOOOOOOOOOOOOOOOOOOOOOOOPOOOOOOOOOOOOOOOOOOOOPOOOOOOOOOOOOOOOOOOOOOOOOOOOOOOOOOOOOOOOPOOOOOOOOOOOOOOOOOOOOOOOOOOOOOOOOOOOOOPOOOOOOOOOOOOOOOOOOOOPOOOOOOOOOOOOOOOOOOOOOOOOOOOOOOOOOOOOOOOPOOOOOOOOOOOOOOOOOOOOOOOOO
OOOOOOOOOOOOOOOOOOOOOOOOOOOOOOOOOOOPPOOOOOOOOOOOOOOOOOOOOOOOOOOOOOOOOOOOOOOOOOOOOOOOOOOOOOOOOOOOOOOOOOOOOOOOOOOPOOOOOOOOOOOOOOOOOOOOPOOOOOOOOOOOOOOOOOOOOOOOOOOOOOOOOOOOOOOOPOOOOOOOOOOOOOOOOOOOOOOOOOOOOOOOOOOOOOPOOOOOOOOOOOOOOOOOOOOPOOOOOOOOOOOOOOOOOOOOOOOOOOOOOOOOOOOOOOOPOOOOOOOOOOOOOOOOOOOOOOOOO
OOOOOOOOOOOOOOOOOOOOOOOOOOOOOOOOOOOOOOOOOOOOQOOOOOOOOOPOOOOOOOOOOOOOOOOOOOOPOOOOOOOOOOOOOOOOOOOOOOOOOOOOOOOOOOOPOOOOOOOOOOOOOOOOOOOOPOOOOOOOOOOOOOOOOOOOOOOOOOOOOOOOOOOOOOOOPOOOOOOOOOOOOOOOOOOOOOOOOOOOOOOOOOOOOOPOOOOOOOOOOOOOOOOOOOOPOOOOOOOOOOOOOOOOOOOOOOOOOOOOOOOOOOOOOOOPOOOOOOOOOOOOOOOOOOOOOOOOO
OOOOOOOOOOOOOOOOOOOOOOOOOOOOOOOOOOOOOOOOOOOOOOOOOOOOOOOOOOOOOOOOOOOOOOOOOOOOOOOOOOOOOOOOOOOOOOOOOOOOOOOOOOOOOOOPOOOOOOOOOOOOOOOOOOOOPOOOOOOOOOOOOOOOOOOOOOOOOOOOOOOOOOOOOOOOPOOOOOOOOOOOOOOOOOOOOOOOOOOOOOOOOOOOOOPOOOOOOOOOOOOOOOOOOOOPOOOOOOOOOOOOOOOOOOOOOOOOOOOOOOOOOOOOOOOPOOOOOOOOOOOOOOOOOOOOOOOOO
OOOOOOOOOOOOOOOOOOOOOOOOOOOOOOOOOOOOOOOOOOOOOOOOOOOOOOOOOOOOOOOOOOOOOOOOOOOOOOOOOOOOOOOOOOOOOOOOOOOOOOOOOOOOOOOPOOOOOOOOOOOOOOOOOOOOPOOOOOOOOOOOOOOOOOOOOOOOOOOOOOOOOOOOOOOOPOOOOOOOOOOOOOOOOOOOOOOOOOOOOOOOOOOOOOPOOOOOOOOOOOOOOOOOOOOPOOOOOOOOOOOOOOOOOOOOOOOOOOOOOOOOOOOOOOOPOOOOOOOOOOOOOOOOOOOOOOOOO
OOOOOOOOOOOOOOOOOOOOOOOOOOOOOOOPOOOOOOOOOOOOOOOOOOOOOOOOOOOOOOOOOOOOOOOOOOOOOOOOOOOOOOOOOOOOOOOOOOOOOOOOOOOOOOOPOOOOOOOOOOOOOOOOOOOOPOOOOOOOOOOOOOOOOOOOOOOOOOOOOOOOOOOOOOOOPOOOOOOOOOOOOOOOOOOOOOOOOOOOOOOOOOOOOOPOOOOOOOOOOOOOOOOOOOOPOOOOOOOOOOOOOOOOOOOOOOOOOOOOOOOOOOOOOOOPOOOOOOOOOOOOOOOOOOOOOOOOO
OOOOOOOOOOOOOOPOOOOOOOOOOOOOOOOOOOOOOOOOOOOOOOOOOOOOOOOOOOOOOOOOOOOOOPOOOOOOOOOOOOOOOOOOOOOOOOOOOOOOOOOOOOOOOOOPOOOOOOOOOOOOOOOOOOOOPOOOOOOOOOOOOOOOOOOOOOOOOOOOOOOOOOOOOOOOPOOOOOOOOOOOOOOOOOOOOOOOOOOOOOOOOOOOOOPOOOOOOOOOOOOOOOOOOOOPOOOOOOOOOOOOOOOOOOOOOOOOOOOOOOOOOOOOOOOPOOOOOOOOOOOOOOOOOOOOOOOOO
OOOOOOOOOOOOOQOOOOOOOOOOOOOOOOOOOOOOOOOOOOOOOOOOOOOOOOOOOOOOOOOOOOOOOOOOOOOOOOOOOOOOOOOOOOOOOOOOOOOOOOOOOOOOOOOPOOOOOOOOOOOOOOOOOOOOPOOOOOOOOOOOOOOOOOOOOOOOOOOOOOOOOOOOOOOOPOOOOOOOOOOOOOOOOOOOOOOOOOOOOOOOOOOOOOPOOOOOOOOOOOOOOOOOOOOPOOOOOOOOOOOOOOOOOOOOOOOOOOOOOOOOOOOOOOOPOOOOOOOOOOOOOOOOOOOOOOOOO
OOOOOOOOOOOOOOOOOOOOOOOOOOOOOOOOOOPOOOOOOOOOOOOOOOOOOOOOOOOOOOOOOOOOOOOOOOOOOOOOOOOQOOOOOOOOOOOOOOOOOOOOOOOOOOOPOOOOOOOOOOOOOOOOOOOOPOOOOOOOOOOOOOOOOOOOOOOOOOOOOOOOOOOOOOOOPOOOOOOOOOOOOOOOOOOOOOOOOOOOOOOOOOOOOOPOOOOOOOOOOOOOOOOOOOOPOOOOOOOOOOOOOOOOOOOOOOOOOOOOOOOOOOOOOOOPOOOOOOOOOOOOOOOOOOOOOOOOO
OOOOOOOOOOOOOOOOOOOOOOOOOOOOOOOOOOOOOOOOOOOOOOOOOOOOOOOOOOOOOOOQOOOOOOOOOOOOOOOOOOOOOOOOOOOOOOOOOOOOOOOOOOOOOOOPOOOOOOOOOOOOOOOOOOOOPOOOOOOOOOOOOOOOOOOOOOOOOOOOOOOOOOOOOOOOPOOOOOOOOOOOOOOOOOOOOOOOOOOOOOOOOOOOOOPOOOOOOOOOOOOOOOOOOOOPOOOOOOOOOOOOOOOOOOOOOOOOOOOOOOOOOOOOOOOPOOOOOOOOOOOOOOOOOOOOOOOOO
OOOOOOOOOOOOOOOOOOOOOOOOOOOOOOOOOOPOOOOOOOOOOOOOOOOOOOOOOOOOOOOOOOOOOOOOOOOOOOOOOOOOOOOOOOOOOOOOOOOOOOOOOOOOOOOPOOOOOOOOOOOOOOOOOOOOPOOOOOOOOOOOOOOOOOOOOOOOOOOOOOOOOOOOOOOOPOOOOOOOOOOOOOOOOOOOOOOOOOOOOOOOOOOOOOPOOOOOOOOOOOOOOOOOOOOPOOOOOOOOOOOOOOOOOOOOOOOOOOOOOOOOOOOOOOOPOOOOOOOOOOOOOOOOOOOOOOOOO
OOOOOOOOOPOOOOOOOOOOOOOOOOOOOOOOOOOOOOOOOOOOOOOOOOOOOOOOOOOOOOOOOOOOOOOOOOPOOOOOOOOOOOOOOOOOOOOOOOOOOOOOOOOOOOOPOOOOOOOOOOOOOOOOOOOOPOOOOOOOOOOOOOOOOOOOOOOOOOOOOOOOOOOOOOOOPOOOOOOOOOOOOOOOOOOOOOOOOOOOOOOOOOOOOOPOOOOOOOOOOOOOOOOOOOOPOOOOOOOOOOOOOOOOOOOOOOOOOOOOOOOOOOOOOOOPOOOOOOOOOOOOOOOOOOOOOOOOO
OOOOOOOOOOOOOOOOOOOOOOOOOOOOOOOOOOOOOOOOOOOOQOOOOOOOOOOOOOOOOOOOOOOOOOOOOOOOOOOOOOOOOOOOOOOOOOOOOOOOOOOOOOOOOOOPOOOOOOOOOOOOOOOOOOOOPOOOOOOOOOOOOOOOOOOOOOOOOOOOOOOOOOOOOOOOPOOOOOOOOOOOOOOOOOOOOOOOOOOOOOOOOOOOOOPOOOOOOOOOOOOOOOOOOOOPOOOOOOOOOOOOOOOOOOOOOOOOOOOOOOOOOOOOOOOPOOOOOOOOOOOOOOOOOOOOOOOOO
OOOOOOOOOOOOOOOOOOOOOOOOOOOOOOOOOOOOOOOOOOOOOOOOOOOOOOOOOOOOOOOOOOOOOOOOOOOOOOOOOOOOOOOOOOOOOOOOOOOOOOOOOOOOOOOPOOOOOOOOOOOOOOOOOOOOPOOOOOOOOOOOOOOOOOOOOOOOOOOOOOOOOOOOOOOOPOOOOOOOOOOOOOOOOOOOOOOOOOOOOOOOOOOOOOPOOOOOOOOOOOOOOOOOOOOPOOOOOOOOOOOOOOOOOOOOOOOOOOOOOOOOOOOOOOOPOOOOOOOOOOOOOOOOOOOOOOOOO
OOOOOOOOOOOOQOOOOOOOOOOOOOOOOOOOOOOOOOOOOOOOOOOOOOOOOOOOOOOOOOOOOOOOOOOOOOOOOOOOOOOOOOOOOOOOOOOOOOOOOOOOOOOOOOOPOOOOOOOOOOOOOOOOOOOOPOOOOOOOOOOOOOOOOOOOOOOOOOOOOOOOOOOOOOOOPOOOOOOOOOOOOOOOOOOOOOOOOOOOOOOOOOOOOOPOOOOOOOOOOOOOOOOOOOOPOOOOOOOOOOOOOOOOOOOOOOOOOOOOOOOOOOOOOOOPOOOOOOOOOOOOOOOOOOOOOOOOO
OOOOOOOOOOOOPOOOOOOOOOOOOOOOOOOOOOOOOOOOOOOOPOOOOOOOOOOOOOOOOOOOOOOOOPOOOOOOOOOOOOOOOOOOOOOOOOOOOOOOOOOOOOOOOOOPOOOOOOOOOOOOOOOOOOOOPOOOOOOOOOOOOOOOOOOOOOOOOOOOOOOOOOOOOOOOPOOOOOOOOOOOOOOOOOOOOOOOOOOOOOOOOOOOOOPOOOOOOOOOOOOOOOOOOOOPOOOOOOOOOOOOOOOOOOOOOOOOOOOOOOOOOOOOOOOPOOOOOOOOOOOOOOOOOOOOOOOOO
OOOOOOOOOOOOOOOOOOOOOOOOOOOPPOOOOOOOOOOOOOOOOOOOOOOOOOOOOOOOOOOOOOOOOOOOOOOOOOOOOOOOOOOOOOOOOOOOOOOOOOOOOOOOOOOPOOOOOOOOOOOOOOOOOOOOPOOOOOOOOOOOOOOOOOOOOOOOOOOOOOOOOOOOOOOOPOOOOOOOOOOOOOOOOOOOOOOOOOOOOOOOOOOOOOPOOOOOOOOOOOOOOOOOOOOPOOOOOOOOOOOOOOOOOOOOOOOOOOOOOOOOOOOOOOOPOOOOOOOOOOOOOOOOOOOOOOOOO
OOOOOOOOOOOOOOOOOOOOOOOOOOOOOOOOOOOOOOOOOOOOOOOOOOOOOOOOOOOOOOOOOOOOOOOOOOOOOOOOOOOOOOOOOOOOOOOOOOOOOOOOOOOOOOOPOOOOOOOOOOOOOOOOOOOOPOOOOOOOOOOOOOOOOOOOOOOOOOOOOOOOOOOOOOOOPOOOOOOOOOOOOOOOOOOOOOOOOOOOOOOOOOOOOOPOOOOOOOOOOOOOOOOOOOOPOOOOOOOOOOOOOOOOOOOOOOOOOOOOOOOOOOOOOOOPOOOOOOOOOOOOOOOOOOOOOOOOO